*****************************************************************
*A  *         *         *     *                   *             *
*** * ***** * ******* *** *** * *************** * *********** * *
*   *     * *       *       * * *     *   *     *   *       * * *
* ******* * ******* ******* * * * ***** * * ******* * ***** *** *
*       * *   *           * * *   *   * * * *   *   * *   *     *
* ******* *** *********** * * * *** * * * * * *** *** *** ***** *
* *   * *   *     *       * *   *   *   *   *   * *     *   *   *
*** * * *** ***** ******* ******* *** ******* * * *** * * *** ***
*   *     *   * *   *   *   *   * *   *     * * *   * * *   *   *
* ***** ***** * *** * * *** * * * ***** *** * * *** * * *** *** *
*   *   *     *   * * *   *   *   *     *   * *   * * *   *   * *
* * ***** ***** * * * *** * ******* ********* * * * ***** * * * *
* * *     *     * * * * * * *       *   *     * * * *     * * * *
* * * ******* *** * * * * *** ******* * * ***** *** * ***** *** *
* *           *   *     *     *       *       *       *        B*
*****************************************************************