*****************************************************************
*A        *       *                         *   *     *   *     *
* ***** * ***** *** ********** **** ***** * * * *** * * * ***** *
*   * * *     *     *             *     * *   *     *   *       *
*** * * ***** ******* *********** ***** * ***************** * ***
*     *   *       *   *       * * *     *     *         *   *   *
* ***** * ******* * *** ***** * * ***** ***** ********* * ***** *
* *   * *   *   *   *   *   *   *     * *   *       *   * *     *
*** * *** * * * ***** * * * *** ***** * * ********* * * * * *** *
*   *   * * * *   *   * * * *   *     *   *     *   * * *   * * *
* ***** * * * *** * *** * * ***** ******* * *** * *** * ***** * *
*   *       * *   * * * * *       *     * * * *   *   *   *   * *
* * * ********* *** * * * ********* ***** * * ***** ***** * *** *
* * * *       * *   * * *         *       * *   *       *   *   *
* * *** ***** * * *** * * *** *** ********* * * * ***** ***** ***
* *       *   *       *       *             * *       *        B*
*****************************************************************